_ _ _ _ _ 4 1 _ _
1 _ _ 2 _ _ 7 _ _
_ _ 7 _ _ 3 _ 5 6
_ 7 8 _ _ _ _ _ 1
3 _ _ _ 1 _ _ _ 4
4 _ _ _ _ _ 2 9 _
6 2 _ 7 _ _ 9 _ _
_ _ 1 _ _ 9 _ _ 5
_ _ 4 6 _ _ _ _ _