_ _ 3 4 7 _ _ 1 6
_ 5 _ _ _ _ 8 _ 4
_ _ _ _ _ _ 9 2 _
_ 6 _ _ 4 _ _ 9 2
_ _ _ _ _ _ _ _ _
5 1 _ _ 9 _ _ 8 _
_ 2 6 _ _ _ _ _ _
8 _ 5 _ _ _ _ 3 _
3 7 _ _ 5 1 2 _ _